5 7
#######
#*   a#
#######
#a   X#
#######