5 5 
#####
#* a#
#####
#a X#
#####